- tiles 600
14 14  14 15  12 15  12 15  12 15  12 15  12 15  12 15   1 33   1 33  12 15  12 15  12 15  12 15  12 15  12 15  12 15  12 15  11 15  11 14
15 14  15 15   1 33   1 33   1 33   1 33   1 33   1 33   1 33   1 33   1 33   1 33   1 33   1 33   1 33   1 33   1 33   1 33  10 15  11 15
 7 13   1 33   1 33   1 33   1 33   1 33   1 33   1 33   1 33   1 33   1 33   1 33   1 33   1 33   1 33   1 33   1 33   1 33   1 33   1 13
 7 13   1 33   1 33   1 33   1 33   1 33   1 33   1 33   1 33   1 33   1 33   1 33   1 33   1 33   1 33   1 33   1 33   1 33   1 33   1 13
 7 13   1 33   1 33   1 33   1 33   1 33   1 33   1 33   1 33   1 33   1 33   1 33   1 33   1 33   1 33   1 33   1 33   1 33   1 33   1 13
 7 13   1 33   1 33   1 33   1 33   1 33   1 33   1 33   1 33   1 33   1 33   1 33   1 33   1 33   1 33   1 33   1 33   1 33   1 33   1 13
 7 13   1 33   1 33   1 33   1 33   1 33   1 33   1 33   1 33   1 33   1 33   1 33   1 33   1 33   1 33   1 33   1 33   1 33   1 33   1 13
 7 13   1 33   1 33   1 33   1 33   1 33   1 33   1 33   1 33   1 33   1 33   1 33   1 33   1 33   1 33   1 33   1 33   1 33   1 33   1 13
 7 13   1 33   1 33   1 34   1 34   1 34   1 34   1 34   1 34   1 34   1 34   1 34   1 34   1 34   1 34   1 34   1 34   1 33   1 33   1 13
 7 13   1 33   2 34   6 17   6 17   6 17   6 17   6 17   6 17   6 17   6 17   6 17   6 17   6 17   6 17   6 17   6 17   0 34   1 33   1 13
 7 13   2 34   6 17   6 17   6 17   6 17   6 17   6 17   6 17   6 17   6 17   6 17   6 17   6 17   6 17   6 17   6 17   6 17   0 34   1 13
 7 13   8 13   6 17   6 17   6 17   6 17   6 17   6 17   6 17   6 17   6 17   6 17   6 17   6 17   6 17   6 17   6 17   6 17   0 13   1 13
 7 13   8 13   6 17   6 17   6 17   6 17   6 17   6 17   6 17   6 17   6 17   6 17   6 17   6 17   6 17   6 17   6 17   6 17   0 13   1 13
 5 16   6 16   6 17   6 17   6 17   6 17   6 17   6 17   6 17   6 17   6 17   6 17   6 17   6 17   6 17   6 17   6 17   6 17   2 16   3 16
 5 17   6 17   6 17   6 17   6 17   6 17   6 17   6 17   6 17   6 17   6 17   6 17   6 17   6 17   6 17   6 17   6 17   6 17   6 17   3 17
 - collision 300
 1 1 1 1 1 1 1 1 0 0 1 1 1 1 1 1 1 1 1 1
 1 1 0 0 0 0 0 0 0 0 0 0 0 0 0 0 0 0 1 1
 1 0 0 0 0 0 0 0 0 0 0 0 0 0 0 0 0 0 0 1
 1 0 0 0 0 0 0 0 0 0 0 0 0 0 0 0 0 0 0 1
 1 0 0 0 0 0 0 0 0 0 0 0 0 0 0 0 0 0 0 1
 1 0 0 0 0 0 0 0 0 0 0 0 0 0 0 0 0 0 0 1
 1 0 0 0 0 0 0 0 0 0 0 0 0 0 0 0 0 0 0 1
 1 0 0 0 0 0 0 0 0 0 0 0 0 0 0 0 0 0 0 1
 1 0 0 0 0 0 0 0 0 0 0 0 0 0 0 0 0 0 0 1
 1 0 0 1 1 1 1 1 1 1 1 1 1 1 1 1 1 0 0 1
 1 0 1 1 1 1 1 1 1 1 1 1 1 1 1 1 1 1 0 1
 1 1 1 1 1 1 1 1 1 1 1 1 1 1 1 1 1 1 1 1
 1 1 1 1 1 1 1 1 1 1 1 1 1 1 1 1 1 1 1 1
 1 1 1 1 1 1 1 1 1 1 1 1 1 1 1 1 1 1 1 1
 1 1 1 1 1 1 1 1 1 1 1 1 1 1 1 1 1 1 1 1
  - portal 10
 xp  yp  xd  yd  map
  9  -1   9  14    1
  8  -1   8  14    1
 
 - npc 6
tp xp yp
1  3  4
2  15 3