- tilesMazeOneofFour 600
 x  y
 6  4   8  4   8  4   8  4   8  4   8  4   8  4   8  4   8  4   8  4   8  4   8  4   8  4   8  4   8  4   8  4   8  4   8  4   8  4   8  4
 6  4   8  4   8  4   8  4   8  4   8  4   8  4   8  4   8  4   8  4   8  4   8  4   8  4   8  4   8  4   8  4   8  4   8  4   8  4   8  4
 6  4   8  4   8  4   8  4   8  4   8  4   8  4   8  4   8  4   8  4   8  4   8  4   8  4   8  4   8  4   8  4   8  4   8  4   8  4   8  4
 6  4   8  4   8  4   8  4   8  4   8  4   8  4   8  4   8  4   8  4   8  4   8  4   8  4   8  4   8  4   8  4   8  4   8  4   8  4   8  4
 6  4   8  4   8  4   8  4   8  4   8  4   8  4   8  4   8  4   8  4   8  4   8  4   8  4   8  4   8  4   8  4   8  4   8  4   8  4   8  4
 6  4   8  4   8  4   8  4   8  4   8  4   8  4   8  4   8  4   8  4   8  4   8  4   8  4   8  4   8  4   8  4   8  4   8  4   8  4   8  4
 6  4   8  4   8  4   8  4   8  4   8  4   8  4   8  4   8  4   8  4   8  4   8  4   8  4   8  4   8  4   8  4   8  4   8  4   8  4   8  4
 6  4   8  4   8  4   8  4   8  4   8  4   8  4   8  4   8  4   8  4   8  4   8  4   8  4   8  4   8  4   8  4   8  4   8  4   8  4   8  4
 6  4   8  4   8  4   8  4   8  4   8  4   8  4   8  4   8  4   8  4   8  4   8  4   8  4   8  4   8  4   8  4   8  4   8  4   8  4   8  4
 6  4   8  4   8  4   8  4   8  4   8  4   8  4   8  4   8  4   8  4   8  4   8  4   8  4   8  4   8  4   8  4   8  4   8  4   8  4   8  4
 6  4   8  4   8  4   8  4   8  4   8  4   8  4   8  4   8  4   8  4   8  4   8  4   8  4   8  4   8  4   8  4   8  4   8  4   8  4   8  4
 6  4   8  4   8  4   8  4   8  4   8  4   8  4   8  4   8  4   8  4   8  4   8  4   8  4   8  4   8  4   8  4   8  4   8  4   8  4   8  4
 6  4   7  4   8  4   8  4   8  4   8  4   8  4   8  4   8  4   8  4   8  4   8  4   8  4   8  4   8  4   8  4   8  4   8  4   8  4   8  4
 6  5   7  5   8  5   8  4   8  4   8  4   8  4   8  4   8  4   8  4   8  4   8  4   8  4   8  4   8  4   8  4   8  4   8  4   8  4   8  4
 6  6   7  6   8  6   9  6   9  6   9  6   9  6   9  6   9  6  22  1   9  6   9  6   9  6   9  6   9  6   9  6   9  6   9  6   9  6   9  6