- tilesMazeOneofFour 600
 6  4   0 22   1 22   1 22   1 22   1 22   2 22   8  4  11 22   8  4   0 22   1 22   1 22   1 22   1 22   1 22   1 22   1 22   1 22   2 22
 6  4   1 23   1 23   1 23   1 23   1 23   1 23   8  4  12 22   8  4  12 22   1 23   1 23   1 23   1 23   1 23  12 22   1 23   1 23   1 23
 6  4   8  4   0 22   1 22   1 22   1 22   1 22   1 22   2 22   8  4  12 22   8  4   8  4   4  6   5  6   8  4  13 22   8  4   8  4  11 22
 6  4   8  4  12 22   1 23   1 23   1 23  12 22   1 23   1 23   8  4  12 22   8  4   8  4   4  7   5  7   8  4   8  4   8  4   8  4  12 22
 6  4   8  4  12 22   8  4  11 22   8  4  12 22   8  4   0 22   1 22   2 22   8  4   8  4   0 22   1 22   1 22   1 22   2 22   8  4  12 22
 6  4   8  4  12 22   8  4  12 22   8  4  12 22   8  4  12 22   1 23   1 23   8  4   8  4   1 23   1 23  12 22   1 23   1 23   8  4  12 22
 6  4   8  4  12 22   8  4  12 22   8  4  12 22   8  4  13 22   8  4   0 22   1 22   1 22   2 22   8  4  12 22   4  6   5  6   8  4  13 22
 6  4   8  4  12 22   8  4  12 22   8  4  12 22   8  4   8  4   8  4  12 22   1 23   1 23   1 23   8  4  12 22   4  7   5  7   8  4   8  4
 6  4   8  4  13 22   8  4  12 22   8  4  12 22   0 22   1 22   2 22  12 22   8  4   0 22   1 22   1 22   1 22   1 22   1 22   1 22   2 22
 6  4   8  4   8  4   8  4  12 22   8  4  12 22   1 23   1 23   1 23  12 22   8  4  12 22   1 23   1 23   1 23   1 23   1 23   1 23  12 22
 6  4   8  4  11 22   8  4   0 22   1 22   2 22   8  4  11 22   8  4  13 22   8  4  12 22   8  4   0 22   1 22   1 22   2 22   8  4  12 22
 6  4   8  4  13 22   8  4   1 23   1 23   1 23   8  4  12 22   8  4   8  4   8  4  12 22   8  4   1 23   1 23   1 23  12 22   8  4  12 22
 6  4   7  4   8  4   0 22   1 22   1 22   1 22   1 22   1 22   1 22   2 22   8  4   0 22   1 22   1 22   2 22   8  4  12 22   8  4  13 22
 6  5   7  5   8  5   1 23   1 23   1 23   1 23   1 23   1 23   1 23  13 22   8  4   1 23   1 23   1 23   1 23   8  4  13 22   8  4   8  4
 6  6   7  6   8  6   9  6   9  6   9  6   9  6   9  6  22  1  22  1   9  6   9  6   9  6   9  6   9  6   9  6   9  6   9  6   9  6   9  6
 - collision 300
 1 1 1 1 1 1 1 0 1 0 1 1 1 1 1 1 1 1 1 1
 1 0 0 0 0 0 0 0 1 0 1 0 0 0 0 0 1 0 0 0
 1 0 1 1 1 1 1 1 1 0 1 0 0 1 1 0 1 0 0 1
 1 0 1 0 0 0 1 0 0 0 1 0 0 1 1 0 0 0 0 1
 1 0 1 0 1 0 1 0 1 1 1 0 0 1 1 1 1 1 0 1
 1 0 1 0 1 0 1 0 1 0 0 0 0 0 0 1 0 0 0 1
 1 0 1 0 1 0 1 0 1 0 1 1 1 1 0 1 1 1 0 1
 1 0 1 0 1 0 1 0 0 0 1 0 0 0 0 1 1 1 0 0
 1 0 0 0 1 0 1 1 1 1 1 0 1 1 1 1 1 1 1 1
 1 0 0 0 1 0 1 0 0 0 1 0 1 0 0 0 0 0 0 1
 1 0 1 0 1 1 1 0 1 0 0 0 1 0 1 1 1 1 0 1
 1 0 1 0 0 0 0 0 1 0 0 0 1 0 0 0 0 1 0 1
 1 0 0 1 1 1 1 1 1 1 1 0 1 1 1 1 0 1 0 1
 1 1 0 0 0 0 0 0 0 0 1 0 0 0 0 0 0 1 0 0
 1 1 1 1 1 1 1 1 0 0 1 1 1 1 1 1 1 1 1 1
 - portal 35
 xp  yp  xd  yd  map
  9  15   9   0    0
  8  15   8   0    0
  7  -1   7  14    3
  9  -1   9  14    3
 19   2   0   2    2
 19   8   0   8    2
 19  14   0  14    2
 - npc 132
tp xp yp  tp xp yp
 0  1 12   0  1 11 
 0  1 10   0  1  9 
 0  1  8   0  1  7 
 0  1  6   0  1  5 
 0  1  4   0  1  3 
 0  1  2   0  1  1 
 0  1  0   0  2  0 
 0  3  0   0  4  0
 0  5  0   0  6  0 
 0  7  0   0  8  0 
 0  9  0   0 10  0 
 0 11  0   0 12  0 
 0 13  0   0 14  0 
 0 15  0   0 16  0 
 0 17  0   0 18  0 
 0 19  0   0 19  1 
 0 19  2   0 19  3 
 0 19  4   0 19  5 
 0 19  6   0 19  7 
 0 19  8   0 19  9 
 0 19 10   0 19 11 
 0 19 12   
 