- tilesMazeOneofFour 600
 3 33   3 33   3 33   3 33   3 33   3 33   3 33   3 33   3 33   3 33   3 33   3 33   3 33   3 33   3 33   3 33   3 33   3 33   3 33   3 33
 3 33   3 33   3 33   3 33   3 33   3 33   3 33   3 33   3 33   3 33   3 33   3 33   3 33   3 33   3 33   3 33   3 33   3 33   3 33   3 33
 3 33   3 33   3 33   3 33   3 33   3 33   3 33   3 33   3 33   3 33   3 33   3 33   3 33   3 33   3 33   3 33   3 33   3 33   3 33   3 33
 3 33   3 33   3 33   3 33   3 33   3 33   3 33   3 33   3 33   3 33   3 33   3 33   3 33   3 33   3 33   3 33   3 33   3 33   3 33   3 33
 3 33   3 33   3 33   3 33   3 33   3 33   3 33   3 33   3 33   3 33   3 33   3 33   3 33   3 33   3 33   3 33   3 33   3 33   3 33   3 33
 3 33   3 33   3 33   3 33   3 33   3 33   3 33   3 33   3 33   3 33   3 33   3 33   3 33   3 33   3 33   3 33   3 33   3 33   3 33   3 33
 3 33   3 33   3 33   3 33   3 33   3 33   3 33   3 33   4 33   6 32   6 32   6 32   6 32   6 32   6 32   6 32   6 32   6 32   6 32   6 32
 3 33   3 33   3 33   3 33   3 33   3 33   3 33   3 34   4 34   6 34   6 34   6 34   6 34   6 34   6 34   6 34   6 34   6 34   6 34   6 34
 3 33   3 33   3 33   3 33   3 33   3 33   3 33   3 36   4 36   6 36   6 36   6 36   6 36   6 36   6 36   6 36   6 36   6 36   6 36   6 36
 3 33   3 33   3 33   3 33   3 33   3 33   3 33   3 36   4 36   6 36   6 36   6 36   6 36   6 36   6 36   6 36   6 36   6 36   6 36   6 36
 3 33   3 33   3 33   3 33   3 33   3 33   3 33   3 36   4 36   6 36   6 36   9 37  10 37   7 39   7 39   7 39   7 39   7 39   7 39   7 39
 3 33   3 33   3 33   3 33   3 33   3 33   3 33   3 36   4 36   6 36   6 36  10 36  11 36   3 33   3 33   3 33   3 33   3 33   3 33   3 33
 3 33   3 33   3 33   3 33   3 33   3 33   3 33   3 36   4 36   6 36   6 36  10 36  11 36   3 33   3 33   3 33   3 33   3 33   3 33   3 33
 3 33   3 33   3 33   3 33   3 33   3 33   3 33   3 36   4 36   6 36   6 36  10 36  11 36   3 33   3 33   3 33   3 33   3 33   3 33   3 33
 3 33   3 33   3 33   3 33   3 33   3 33   3 33   3 36   4 36   6 36   6 36  10 36  11 36   3 33   3 33   3 33   3 33   3 33   3 33   3 33
 
 - collision 300
 1 1 1 1 1 1 1 1 1 1 1 1 1 1 1 1 1 1 1 1
 1 1 1 1 1 1 1 1 1 1 1 1 1 1 1 1 1 1 1 1
 1 1 1 1 1 1 1 1 1 1 1 1 1 1 1 1 1 1 1 1
 1 1 1 1 1 1 1 1 1 1 1 1 1 1 1 1 1 1 1 1
 1 1 1 1 1 1 1 1 1 1 1 1 1 1 1 1 1 1 1 1
 1 1 1 1 1 1 1 1 1 1 1 1 1 1 1 1 1 1 1 1
 1 1 1 1 1 1 1 1 1 1 1 1 1 1 1 1 1 1 1 1
 1 1 1 1 1 1 1 1 1 1 1 1 1 1 1 1 1 1 1 1
 1 1 1 1 1 1 1 1 1 0 0 0 0 0 0 0 0 0 0 0
 1 1 1 1 1 1 1 1 1 0 0 0 0 0 0 0 0 0 0 0
 1 1 1 1 1 1 1 1 1 0 0 1 1 1 1 1 1 1 1 1
 1 1 1 1 1 1 1 1 1 0 0 1 1 1 1 1 1 1 1 1
 1 1 1 1 1 1 1 1 1 0 0 1 1 1 1 1 1 1 1 1
 1 1 1 1 1 1 1 1 1 0 0 1 1 1 1 1 1 1 1 1
 1 1 1 1 1 1 1 1 1 0 0 1 1 1 1 1 1 1 1 1
 
 - portal 20
 xp  yp  xd  yd  map
 20   8   0   8    9
 20   9   0   9    9
  9  15   9   0    7
 10  15  10   0    7