- tilesMazeOneofFour 600
 3 33   3 33   3 33   3 33   3 33   3 33   3 33   3 33   3 33   3 33   3 33   3 33   3 33   5 32   6 32   6 32   6 32   6 32   6 32   9 32
 3 33   3 33   3 33   3 33   3 33   3 33   3 33   3 33   3 33   3 33   3 33   3 33   4 33   5 33   6 34   6 34   6 34   6 34   6 34   9 33
 3 33   3 33   3 33   3 33   3 33   3 33   3 33   3 33   3 33   3 33   3 33   3 33   3 36   4 36   6 36   6 36   6 36   6 36   6 36  10 36
 6 32   6 32   6 32   9 32   3 33   3 33   3 33   3 33   5 32   6 32   6 32   6 32   5 33   4 36   6 36   6 36   6 36   6 36   6 36  10 36
 6 34   6 34   6 34   9 33   9 32   3 33   3 33   4 33   5 33   6 34   6 34   6 34   6 34   5 35   6 36   6 36   6 36   6 36   6 36  10 36
 6 36   6 36   6 36   9 35   9 33   9 32   3 33   3 36   4 36   6 36   6 36   6 36   6 36   6 36   6 36   6 36   6 36   6 36   6 36  10 36
 6 36   6 36   6 36   6 36   9 35   9 33   6 32   5 33   5 35   6 36   6 36   6 36   6 36   6 36   6 36   6 36   6 36   6 36   9 37  10 37
 5 37   6 36   6 36   6 36   6 36   9 35   6 34   5 35   6 36   6 36   6 36   9 37   7 39   5 37   6 36   6 36   9 37  10 37   7 39  10 38
 4 37   5 37   6 36   6 36   6 36   6 36   6 36   6 36   6 36   6 36   6 36  10 36   3 33   4 36   6 36   6 36   9 35   9 33  10 33   3 33
 4 38   4 37   5 37   6 36   6 36   6 36   6 36   6 36   6 36   6 36   9 37  10 37   3 33   4 36   6 36   6 36   6 36   9 35   9 33  10 33
 3 33   4 38   7 39   7 39   7 39   7 39   7 39   7 39   7 39   7 39   7 39  10 38   3 33   4 36   6 36   6 36   6 36   6 36  10 36  11 36
 3 33   3 33   3 33   3 33   3 33   3 33   3 33   3 33   3 33   3 33   3 33   3 33   3 33   4 36   6 36   6 36   6 36   6 36  10 36  11 36
 3 33   3 33   3 33   3 33   3 33   3 33   3 33   3 33   3 33   3 33   3 33   3 33   3 33   4 37   5 37   6 36   6 36   9 37  10 37  11 37
 3 33   3 33   3 33   3 33   3 33   3 33   3 33   3 33   3 33   3 33   3 33   3 33   3 33   4 38   7 39   7 39   7 39   7 39  10 38   3 33
 3 33   3 33   3 33   3 33   3 33   3 33   3 33   3 33   3 33   3 33   3 33   3 33   3 33   3 33   3 33   3 33   3 33   3 33   3 33   3 33
 
 - collision 300
 1 1 1 1 1 1 1 1 1 1 1 1 1 1 1 1 1 1 1 1
 1 1 1 1 1 1 1 1 1 1 1 1 1 1 1 1 1 1 1 1
 1 1 1 1 1 1 1 1 1 1 1 1 1 1 0 0 0 0 0 1
 1 1 1 1 1 1 1 1 1 1 1 1 1 1 0 0 0 0 0 1
 1 1 1 1 1 1 1 1 1 1 1 1 1 1 0 0 0 0 0 1
 0 0 0 1 1 1 1 1 1 0 0 0 0 0 0 0 0 0 0 1
 0 0 0 0 1 1 1 1 1 0 0 0 0 0 0 0 0 0 1 1
 1 0 0 0 0 1 1 1 0 0 0 1 1 1 0 0 1 1 1 1
 1 1 0 0 0 0 0 0 0 0 0 1 1 1 0 0 1 1 1 1
 1 1 1 0 0 0 0 0 0 0 1 1 1 1 0 0 0 1 1 1
 1 1 1 1 1 1 1 1 1 1 1 1 1 1 0 0 0 0 1 1
 1 1 1 1 1 1 1 1 1 1 1 1 1 1 0 0 0 0 1 1
 1 1 1 1 1 1 1 1 1 1 1 1 1 1 1 0 0 1 1 1
 1 1 1 1 1 1 1 1 1 1 1 1 1 1 1 1 1 1 1 1
 1 1 1 1 1 1 1 1 1 1 1 1 1 1 1 1 1 1 1 1
 
 - portal 10
 xp  yp  xd  yd  map
 -1   5  19   5    9
 -1   6  19   6    9