- tilesMazeOneofFour 600
 3 33   3 33   3 33   3 33   3 33   3 33   3 33   3 33   3 33   3 33   3 33   3 33   3 33   3 33   3 33   3 33   3 33   3 33   3 33   3 33
 3 33   3 33   3 33   3 33   3 33   3 33   3 33   3 33   3 33   3 33   3 33   3 33   3 33   3 33   3 33   3 33   3 33   3 33   3 33   3 33
 3 33   3 33   3 33   3 33   3 33   3 33   3 33   3 33   3 33   3 33   3 33   3 33   3 33   3 33   3 33   3 33   3 33   3 33   3 33   3 33
 3 33   3 33   3 33   3 33   3 33   3 33   3 33   3 33   3 33   3 33   3 33   3 33   3 33   3 33   3 33   3 33   3 33   3 33   3 33   3 33
 3 33   3 33   3 33   3 33   3 33   3 33   3 33   3 33   3 33   3 33   3 33   3 33   3 33   3 33   3 33   3 33   3 33   3 33   3 33   3 33
 3 33   3 33   3 33   3 33   3 33   3 33   3 33   3 33   3 33   3 33   3 33   3 33   3 33   3 33   3 33   3 33   3 33   3 33   3 33   3 33
 6 32   6 32   6 32   6 32   6 32   6 32   6 32   6 32   6 32   6 32   6 32   6 32   6 32   6 32   6 32   6 32   6 32   6 32   6 32   6 32
 6 34   6 34   6 34   6 34   6 34   6 34   6 34   6 34   6 34   6 34   6 34   6 34   6 34   6 34   6 34   6 34   6 34   6 34   6 34   6 34
 6 36   6 36   6 36   6 36   6 36   6 36   6 36   6 36   6 36   6 36   6 36   6 36   6 36   6 36   6 36   6 36   6 36   6 36   6 36   6 36
 6 36   6 36   6 36   6 36   6 36   6 36   6 36   6 36   6 36   6 36   6 36   6 36   6 36   6 36   6 36   6 36   6 36   6 36   6 36   6 36
 7 39   7 39   7 39   7 39   7 39   7 39   7 39   7 39   7 39   7 39   7 39   7 39   7 39   7 39   7 39   7 39   7 39   7 39   7 39   7 39
 3 33   3 33   3 33   3 33   3 33   3 33   3 33   3 33   3 33   3 33   3 33   3 33   3 33   3 33   3 33   3 33   3 33   3 33   3 33   3 33
 3 33   3 33   3 33   3 33   3 33   3 33   3 33   3 33   3 33   3 33   3 33   3 33   3 33   3 33   3 33   3 33   3 33   3 33   3 33   3 33
 3 33   3 33   3 33   3 33   3 33   3 33   3 33   3 33   3 33   3 33   3 33   3 33   3 33   3 33   3 33   3 33   3 33   3 33   3 33   3 33
 3 33   3 33   3 33   3 33   3 33   3 33   3 33   3 33   3 33   3 33   3 33   3 33   3 33   3 33   3 33   3 33   3 33   3 33   3 33   3 33
 
 - collision 300
 1 1 1 1 1 1 1 1 1 1 1 1 1 1 1 1 1 1 1 1
 1 1 1 1 1 1 1 1 1 1 1 1 1 1 1 1 1 1 1 1
 1 1 1 1 1 1 1 1 1 1 1 1 1 1 1 1 1 1 1 1
 1 1 1 1 1 1 1 1 1 1 1 1 1 1 1 1 1 1 1 1
 1 1 1 1 1 1 1 1 1 1 1 1 1 1 1 1 1 1 1 1
 1 1 1 1 1 1 1 1 1 1 1 1 1 1 1 1 1 1 1 1
 1 1 1 1 1 1 1 1 1 1 1 1 1 1 1 1 1 1 1 1
 1 1 1 1 1 1 1 1 1 1 1 1 1 1 1 1 1 1 1 1
 0 0 0 0 0 0 0 0 0 0 0 0 0 0 0 0 0 0 0 0
 0 0 0 0 0 0 0 0 0 0 0 0 0 0 0 0 0 0 0 0
 1 1 1 1 1 1 1 1 1 1 1 1 1 1 1 1 1 1 1 1
 1 1 1 1 1 1 1 1 1 1 1 1 1 1 1 1 1 1 1 1
 1 1 1 1 1 1 1 1 1 1 1 1 1 1 1 1 1 1 1 1
 1 1 1 1 1 1 1 1 1 1 1 1 1 1 1 1 1 1 1 1
 1 1 1 1 1 1 1 1 1 1 1 1 1 1 1 1 1 1 1 1
 
 - portal 20
 xp  yp  xd  yd  map
 20   8   0   8    7
 20   9   0   9    7
 -1   8  19   8   13
 -1   9  19   9   13

 - npc 6
 tp xp yp
  0  9  8
  0  9  9