- tilesMazeOneofFour 600
 4 34   6 34   6 34   6 34   6 34   6 34   6 34   6 34   6 34   6 36   6 36   6 34   6 34   6 34   6 34   6 34   6 34   6 34   6 34   9 33
 4 36   6 36   6 36   6 36   6 36   6 36   6 36   6 36   6 36   6 36   6 36   6 36   6 36   6 36   6 36   6 36   6 36   6 36   6 36  10 36
 4 36   6 36   6 36   6 36   6 36   6 36   6 36   6 36   6 36   6 36   6 36   6 36   6 36   6 36   6 36   6 36   6 36   6 36   6 36  10 36
 4 36   6 36   6 36   6 36   6 36   6 36   6 36   6 36   6 36   6 36   6 36   6 36   6 36   6 36   6 36   6 36   6 36   6 36   6 36  10 36
 4 36   6 36   6 36   6 36   6 36   6 36   6 36   6 36   6 36   6 36   6 36   6 36   6 36   6 36   6 36   6 36   6 36   6 36   6 36  10 36
 4 36   6 36   6 36   6 36   6 36   6 36   6 36   6 36   6 36   6 36   6 36   6 36   6 36   6 36   6 36   6 36   6 36   6 36   6 36  10 36
 4 36   6 36   6 36   6 36   6 36   6 36   6 36   6 36   6 36   6 36   6 36   6 36   6 36   6 36   6 36   6 36   6 36   6 36   6 36  10 36
 4 36   6 36   6 36   6 36   6 36   6 36   6 36   6 36   6 36   6 36   6 36   6 36   6 36   6 36   6 36   6 36   6 36   6 36   6 36  10 36
 4 36   6 36   6 36   6 36   6 36   6 36   6 36   6 36   6 36   6 36   6 36   6 36   6 36   6 36   6 36   6 36   6 36   6 36   6 36  10 36
 4 36   6 36   6 36   6 36   6 36   6 36   6 36   6 36   6 36   6 36   6 36   6 36   6 36   6 36   6 36   6 36   6 36   6 36   6 36  10 36
 4 36   6 36   6 36   6 36   6 36   6 36   6 36   6 36   6 36   6 36   6 36   6 36   6 36   6 36   6 36   6 36   6 36   6 36   6 36  10 36
 4 36   6 36   6 36   6 36   6 36   6 36   6 36   6 36   6 36   6 36   6 36   6 36   6 36   6 36   6 36   6 36   6 36   6 36   6 36  10 36
 4 36   6 36   6 36   6 36   6 36   6 36   6 36   6 36   6 36   6 36   6 36   6 36   6 36   6 36   6 36   6 36   6 36   6 36   6 36  10 36
 4 36   6 36   6 36   6 36   6 36   6 36   6 36   6 36   6 36   6 36   6 36   6 36   6 36   6 36   6 36   6 36   6 36   6 36   6 36  10 36
 4 37   7 39   7 39   7 39   7 39   7 39   7 39   7 39   7 39  12 35  13 35   7 39   7 39   7 39   7 39   7 39   7 39   7 39   7 39   9 38
 
 - collision 300
 1 1 1 1 1 1 1 1 1 0 0 1 1 1 1 1 1 1 1 1
 1 0 0 0 0 0 0 0 0 0 0 0 0 0 0 0 0 0 0 1
 1 0 0 0 0 0 0 0 0 0 0 0 0 0 0 0 0 0 0 1
 1 0 0 0 0 0 0 0 0 0 0 0 0 0 0 0 0 0 0 1
 1 0 0 0 0 0 0 0 0 0 0 0 0 0 0 0 0 0 0 1
 1 0 0 0 0 0 0 0 0 0 0 0 0 0 0 0 0 0 0 1
 1 0 0 0 0 0 0 0 0 0 0 0 0 0 0 0 0 0 0 1
 1 0 0 0 0 0 0 0 0 0 0 0 0 0 0 0 0 0 0 1
 1 0 0 0 0 0 0 0 0 0 0 0 0 0 0 0 0 0 0 1
 1 0 0 0 0 0 0 0 0 0 0 0 0 0 0 0 0 0 0 1
 1 0 0 0 0 0 0 0 0 0 0 0 0 0 0 0 0 0 0 1
 1 0 0 0 0 0 0 0 0 0 0 0 0 0 0 0 0 0 0 1
 1 0 0 0 0 0 0 0 0 0 0 0 0 0 0 0 0 0 0 1
 1 0 0 0 0 0 0 0 0 0 0 0 0 0 0 0 0 0 0 1
 1 1 1 1 1 1 1 1 1 0 0 1 1 1 1 1 1 1 1 1
 
 - portal 20
 xp  yp  xd  yd  map
  9  -1   9  14   13
 10  -1  10  14   13
  9  14   3  11   15
 10  14   4  11   15

 - npc 9
 tp xp yp
 11 14  3
 13  0  7
 11 14 11