- tilesMazeOneofFour 600
 3 33   3 33   3 33   3 33   3 33   3 33   3 33   3 33   3 33   3 33   3 33   3 33   3 33   3 33   3 33   3 33   3 33   3 33   3 33   3 33
 3 33   3 33   3 33   3 33   3 33   3 33   3 33   3 33   3 33   3 33   3 33   3 33   3 33   3 33   3 33   3 33   3 33   3 33   3 33   3 33
 3 33   3 33   3 33   3 33   3 33   3 33   3 33   3 33   3 33   3 33   3 33   3 33   3 33   3 33   3 33   3 33   3 33   3 33   3 33   3 33
 3 33   3 33   3 33   3 33   3 33   3 33   3 33   3 33   3 33   3 33   3 33   3 33   3 33   3 33   3 33   3 33   3 33   3 33   3 33   3 33
 3 33   3 33   3 33   3 33   3 33   3 33   3 33   3 33   3 33   3 33   3 33   3 33   3 33   3 33   3 33   3 33   3 33   3 33   3 33   3 33
 3 33   3 33   3 33   3 33   3 33   3 33   3 33   3 33   3 33   3 33   3 33   3 33   3 33   3 33   3 33   3 33   3 33   3 33   3 33   3 33
 3 33   3 33   3 33   3 33   3 33   3 33   3 33   3 33   3 33   3 33   3 33   3 33   3 33   3 33   3 33   3 33   3 33   3 33   6 32   6 32
 3 33   3 33   3 33   3 33   3 33   3 33   3 33   3 33   3 33   3 33   3 33   3 33   3 33   3 33   3 33   3 33   3 33   3 33   6 34   6 34
 3 33   3 33   3 33   3 33   3 33   3 33   3 33   3 33   3 33   3 33   3 33   3 33   3 33   3 33   3 33   3 33   3 33   3 33   6 36   6 36
 3 33   3 33   3 33   3 33   3 33   3 33   3 33   3 33   3 33   3 33   3 33   3 33   3 33   3 33   3 33   3 33   3 33   3 33   6 36   6 36
 3 33   3 33   3 33   3 33   3 33   3 33   3 33   3 33   3 33   3 33   3 33   3 33   3 33   3 33   3 33   3 33   3 33   3 33   7 39   7 39
 3 33   3 33   3 33   3 33   3 33   3 33   3 33   3 33   3 33   3 33   3 33   3 33   3 33   3 33   3 33   3 33   3 33   3 33   3 33   3 33
 3 33   3 33   3 33   3 33   3 33   3 33   3 33   3 33   3 33   3 33   3 33   3 33   3 33   3 33   3 33   3 33   3 33   3 33   3 33   3 33
 3 33   3 33   3 33   3 33   3 33   3 33   3 33   3 33   3 33   3 33   3 33   3 33   3 33   3 33   3 33   3 33   3 33   3 33   3 33   3 33
 3 33   3 33   3 33   3 33   3 33   3 33   3 33   3 33   3 33   3 33   3 33   3 33   3 33   3 33   3 33   3 33   3 33   3 33   3 33   3 33
 
 - collision 300
 1 1 1 1 1 1 1 1 1 0 0 1 1 1 1 1 1 1 1 1
 1 0 0 0 0 0 0 0 0 0 0 0 0 0 0 0 0 0 0 1
 1 0 0 0 0 0 0 0 0 0 0 0 0 0 0 0 0 0 0 1
 1 0 0 0 0 0 0 0 0 0 0 0 0 0 0 0 0 0 0 1
 1 0 0 0 0 0 0 0 0 0 0 0 0 0 0 0 0 0 0 1
 1 0 0 0 0 0 0 0 0 0 0 0 0 0 0 0 0 0 0 1
 1 0 0 0 0 0 0 0 0 0 0 0 0 0 0 0 0 0 0 1
 1 0 0 0 0 0 0 0 0 0 0 0 0 0 0 0 0 0 0 1
 1 0 0 0 0 0 0 0 0 0 0 0 0 0 0 0 0 0 0 1
 1 0 0 0 0 0 0 0 0 0 0 0 0 0 0 0 0 0 0 1
 1 0 0 0 0 0 0 0 0 0 0 0 0 0 0 0 0 0 0 1
 1 0 0 0 0 0 0 0 0 0 0 0 0 0 0 0 0 0 0 1
 1 0 0 0 0 0 0 0 0 0 0 0 0 0 0 0 0 0 0 1
 1 0 0 0 0 0 0 0 0 0 0 0 0 0 0 0 0 0 0 1
 1 1 1 1 1 1 1 1 1 0 0 1 1 1 1 1 1 1 1 1
 
 - portal 20
 xp  yp  xd  yd  map
  8  -1   8  19   13
  9  -1   9  19   13