- tilesMazeFourofFour 600
 6  4   4  7   5  7   4  7   5  7   4  7   5  7   4  7   5  7   4  7   5  7   4  7   5  7   4  7   5  7   4  7   5  7   4  7   5  7   4  7
 6  4   8  4   8  4   8  4   8  4   8  4   8  4   8  4   8  4   8  4   8  4   8  4   8  4   8  4   8  4   8  4   8  4   8  4   8  4   8  4
 6  4   8  4   8  4   8  4   8  4   8  4   8  4   8  4   8  4   8  4   8  4   8  4   8  4   8  4   8  4   8  4   8  4   8  4   8  4   8  4
 6  4   8  4   8  4   8  4   8  4   8  4   8  4   8  4   8  4   8  4   8  4   8  4   8  4   8  4   8  4   8  4   8  4   8  4   8  4   8  4
 6  4   8  4   8  4   8  4   8  4   8  4   8  4   8  4   8  4   8  4   8  4   8  4   8  4   8  4   8  4   8  4   8  4   8  4   8  4   8  4
 6  4   8  4   8  4   8  4   8  4   8  4   8  4   8  4   8  4   8  4   8  4   8  4   8  4   8  4   8  4   8  4   8  4   8  4   8  4   8  4
 6  4   8  4   8  4   8  4   8  4   8  4   8  4   8  4   8  4   8  4   8  4   8  4   8  4   8  4   8  4   8  4   8  4   8  4   8  4   8  4
 6  4   8  4   8  4   8  4   8  4   8  4   8  4   8  4   8  4   8  4   8  4   8  4   8  4   8  4   8  4   8  4   8  4   8  4   8  4   8  4
 6  4   8  4   8  4   8  4   8  4   8  4   8  4   8  4   8  4   8  4   8  4   8  4   8  4   8  4   8  4   8  4   8  4   8  4   8  4   8  4
 6  4   8  4   7  0   8  0   8  0   0  6   1  6   2  6   3  6  11  0   8  4   8  4   8  4   8  4   8  4   8  4   8  4   8  4   8  4   8  4
 6  4   6  1   7  1  17  6  18  6   0  6   1  6   2  6   3  6  11  1  11  0   8  4   8  4   8  4   8  4   8  4   8  4   8  4   8  4   8  4
15 11   6  2   7  2  17  7  18  7   0  6   1  6   2  6   3  6  11  2  11  1   8  0   8  0   8  0   8  0   8  0   8  0   8  0   8  0   8  0
15 11   6  3  14 16   9  8   9  8   0  7   1  7   2  7   3  7  11 16  11  2   8  1   8  1   8  1   8  1   8  1   8  1   8  1   8  1   8  1
15 11  16 11   9  8   9  8   9  8   9  8   9  8   9  8   9  8   9  8  11 16   8  1   8  1   8  1   8  1   8  1   8  1   8  1   8  1   8  1
15 11  15 11  12 13  12 13  12 13  12 13  12 13  12 13  12 13  12 13  12 13  12 13  12 13  12 13  12 13  12 13  12 13  12 13  12 13  12 13
 - collision 300
 1 1 1 1 1 1 1 1 1 1 1 1 1 1 1 1 1 1 1 1
 1 0 0 0 0 0 0 0 0 0 0 0 0 0 0 0 0 0 0 0
 1 0 0 0 0 0 0 0 0 0 0 0 0 0 0 0 0 0 0 0
 1 0 0 0 0 0 0 0 0 0 0 0 0 0 0 0 0 0 0 0
 1 0 0 0 0 0 0 0 0 0 0 0 0 0 0 0 0 0 0 0
 1 0 0 0 0 0 0 0 0 0 0 0 0 0 0 0 0 0 0 0
 1 0 0 0 0 0 0 0 0 0 0 0 0 0 0 0 0 0 0 0
 1 0 0 0 0 0 0 0 0 0 0 0 0 0 0 0 0 0 0 0
 1 0 0 0 0 0 0 0 0 0 0 0 0 0 0 0 0 0 0 0
 1 0 1 1 1 1 0 0 1 1 0 0 0 0 0 0 0 0 0 0
 1 1 1 1 1 1 0 0 1 1 1 0 0 0 0 0 0 0 0 0
 1 1 1 0 0 1 0 0 1 1 1 1 0 0 0 0 0 0 0 0
 1 1 0 0 0 0 0 0 0 0 1 1 1 1 1 1 1 1 1 1
 1 1 0 0 0 0 0 0 0 0 0 1 1 1 1 1 1 1 1 1
 1 1 1 1 1 1 1 1 1 1 1 1 1 1 1 1 1 1 1 1
 - portal 65
 xp  yp  xd  yd  map
  3  10   9  13   14
  4  10  10  13   14
 20   1   0   1   16
 20   2   0   2   16
 20   3   0   3   16
 20   4   0   4   16
 20   5   0   5   16
 20   6   0   6   16
 20   7   0   7   16
 20   8   0   8   16
 20   9   0   9   16
 20  10   0  10   16
 20  11   0  11   16