- tilesMazeFourofFour 600
 6  4   8  4   8  4   8  4   8  4   8  4   8  4   8  4   8  4   8  4   8  4   8  4   8  4   8  4   8  4   8  4   8  4   8  4   8  4   8  4
 6  4   8  4   8  4   8  4   8  4   8  4   8  4   8  4   8  4   8  4   8  4   8  4   8  4   8  4   8  4   8  4   8  4   8  4   8  4   8  4
 6  4   8  4   8  4   8  4   8  4   8  4   8  4   8  4   8  4   8  4   8  4   8  4   8  4   8  4   8  4   8  4   8  4   8  4   8  4   8  4
 6  4   8  4   8  4   8  4   8  4   8  4   8  4   8  4   8  4   8  4   8  4   8  4   8  4   8  4   8  4   8  4   8  4   8  4   8  4   8  4
 6  4   8  4   8  4   8  4   8  4   8  4   8  4   8  4   8  4   8  4   8  4   8  4   8  4   8  4   8  4   8  4   8  4   8  4   8  4   8  4
 6  4   8  4   8  4   8  4   8  4   8  4   8  4   8  4   8  4   8  4   8  4   8  4   8  4   8  4   8  4   8  4   8  4   8  4   8  4   8  4
 6  4   8  4   8  4   8  4   8  4   8  4   8  4   8  4   8  4   8  4   8  4   8  4   8  4   8  4   8  4   8  4   8  4   8  4   8  4   8  4
 6  4   8  4   8  4   8  4   8  4   8  4   8  4   8  4   8  4   8  4   8  4   8  4   8  4   8  4   8  4   8  4   8  4   8  4   8  4   8  4
 6  4   8  4   8  4   8  4   8  4   8  4   8  4   8  4   8  4   8  4   8  4   8  4   8  4   8  4   8  4   8  4   8  4   8  4   8  4   8  4
 6  4   8  4   8  4   8  4   8  4   8  4   8  4   8  4   8  4   8  4   8  4   8  4   8  4   8  4   8  4   8  4   8  4   8  4   8  4   8  4
 6  4   8  4   8  4   8  4   8  4   8  4   8  4   8  4   8  4   8  4   8  4   8  4   8  4   8  4   8  4   8  4   8  4   8  4   8  4   8  4
 6  4   8  4   8  4   8  4   8  4   8  4   8  4   8  4   8  4   8  4   8  4   8  4   8  4   8  4   8  4   8  4   8  4   8  4   8  4   8  4
 6  4   8  4   8  4   8  4   8  4   8  4   8  4   8  4   8  4   8  4   8  4   8  4   8  4   8  4   8  4   8  4   8  4   8  4   8  4   8  4
 6  4   8  4   8  4   8  4   8  4   8  4   8  4   8  4   8  4   8  4   8  4   8  4   8  4   8  4   8  4   8  4   8  4   8  4   8  4   8  4
15 11   4  6   5  6   4  6   5  6   4  6   5  6   4  6   5  6   4  6   5  6   4  6   5  6   4  6   5  6   4  6   5  6   4  6   5  6   4  6
 - collision 300
 1 0 0 0 0 0 0 0 0 0 0 0 0 0 0 0 0 0 0 0
 1 0 0 0 0 0 0 0 0 0 0 0 0 0 0 0 0 0 0 0
 1 0 0 0 0 0 0 0 0 0 0 0 0 0 0 0 0 0 0 0
 1 0 0 0 0 0 0 0 0 0 0 0 0 0 0 0 0 0 0 0
 1 0 0 0 0 0 0 0 0 0 0 0 0 0 0 0 0 0 0 0
 1 0 0 0 0 0 0 0 0 0 0 0 0 0 0 0 0 0 0 0
 1 0 0 0 0 0 0 0 0 0 0 0 0 0 0 0 0 0 0 0
 1 0 0 0 0 0 0 0 0 0 0 0 0 0 0 0 0 0 0 0
 1 0 0 0 0 0 0 0 0 0 0 0 0 0 0 0 0 0 0 0
 1 0 0 0 0 0 0 0 0 0 0 0 0 0 0 0 0 0 0 0
 1 0 0 0 0 0 0 0 0 0 0 0 0 0 0 0 0 0 0 0
 1 0 0 0 0 0 0 0 0 0 0 0 0 0 0 0 0 0 0 0
 1 0 0 0 0 0 0 0 0 0 0 0 0 0 0 0 0 0 0 0
 1 0 0 0 0 0 0 0 0 0 0 0 0 0 0 0 0 0 0 0
 1 1 1 1 1 1 1 1 1 1 1 1 1 1 1 1 1 1 1 1