- tilesMazeTwoofFour 600
 0 22   1 22   1 22   1 22   1 22   1 22   1 22   1 22   1 22   1 22   1 22   1 22   1 22   1 22   1 22   1 22   1 22   2 22   8  4  12  4
 1 23   1 23  12 22   1 23   1 23   1 23   1 23   1 23  12 22   1 23   1 23   1 23   1 23   1 23   1 23  12 22   1 23   1 23   8  4  12  4
11 22   8  4  12 22   8  4   0 22   1 22   2 22   8  4  12 22   8  4   0 22   1 22   1 22   2 22   8  4  12 22   8  4   8  4   8  4  12  4
12 22   8  4  12 22   8  4   1 23   1 23  12 22   8  4  12 22   8  4  12 22   1 23   1 23   1 23   8  4  12 22   8  4  11 22   8  4  12  4
12 22   8  4   0 22   1 22   2 22   8  4  12 22   8  4  12 22   8  4  12 22   8  4   0 22   1 22   1 22   2 22   8  4  12 22   8  4  12  4
12 22   8  4   1 23   1 23   1 23   8  4  12 22   8  4  12 22   8  4  12 22   8  4   1 23   1 23   1 23   1 23   8  4  12 22   8  4  12  4
 0 22   1 22   1 22   1 22   1 22   1 22   2 22   8  4  12 22   8  4  12 22   8  4   8  4   8  4   8  4   0 22   1 22  12 22   8  4  12  4
 1 23   1 23   1 23   1 23   1 23   1 23   1 23   8  4  12 22   8  4  12 22   8  4  11 22   8  4   8  4   1 23   1 23  12 22   8  4  12  4
11 22   8  4   8  4   0 22   1 22   1 22   1 22   1 22   2 22   8  4  12 22   8  4  12 22   8  4   0 22   1 22   1 22  12 22   8  4  12  4
13 22   8  4   8  4  12 22   1 23   1 23   1 23   1 23   1 23   8  4  12 22   8  4  12 22   8  4   1 23   1 23   1 23  12 22   8  4  12  4
 4  6   5  6   8  4  13 22   8  4   0 22   1 22   1 22   1 22   1 22   1 22   1 22   1 22   1 22   1 22   2 22   8  4  12 22   8  4  12  4
 4  7   5  7   8  4   8  4   8  4  12 22   1 23   1 23   1 23   1 23   1 23   1 23   1 23   1 23   1 23   1 23   8  4  13 22   8  4  12  4
 1 22   1 22   1 22   1 22   1 22   1 22   1 22   1 22   1 22   1 22   1 22   1 22   1 22   1 22   1 22   1 22   2 22   8  4  11  4  12  4
 1 23   1 23   1 23   1 23   1 23   1 23   1 23   1 23   1 23   1 23   1 23   1 23   1 23   1 23   1 23   1 23   1 23  10  5  11  5  12  5
 9  6   9  6   9  6   9  6   9  6   9  6   9  6   9  6   9  6   9  6   9  6   9  6   9  6   9  6   9  6   9  6   9  6  10  6  11  6  12  6
 - collision 300
 1 1 1 1 1 1 1 1 1 1 1 1 1 1 1 1 1 1 0 1
 0 0 1 0 0 0 0 0 1 0 0 0 0 0 0 1 0 0 0 1
 1 0 1 0 1 1 1 0 1 0 1 1 1 1 0 1 0 0 0 1
 1 0 1 0 0 0 1 0 1 0 1 0 0 0 0 1 0 1 0 1
 1 0 1 1 1 0 1 0 1 0 1 0 1 1 1 1 0 1 0 1
 1 0 0 0 0 0 1 0 1 0 1 0 0 0 0 0 0 1 0 1
 1 1 1 1 1 1 1 0 1 0 1 0 0 0 0 1 1 1 0 1
 0 0 0 0 0 0 0 0 1 0 1 0 1 0 0 0 0 1 0 1
 1 0 0 1 1 1 1 1 1 0 1 0 1 0 1 1 1 1 0 1
 1 0 0 1 0 0 0 0 0 0 1 0 1 0 0 0 0 1 0 1
 1 1 0 1 0 1 1 1 1 1 1 1 1 1 1 1 0 1 0 1
 1 1 0 0 0 1 0 0 0 0 0 0 0 0 0 0 0 1 0 1
 1 1 1 1 1 1 1 1 1 1 1 1 1 1 1 1 1 0 0 1
 0 0 0 0 0 0 0 0 0 0 0 0 0 0 0 0 0 0 1 1
 1 1 1 1 1 1 1 1 1 1 1 1 1 1 1 1 1 1 1 1
 - portal 20
 xp  yp  xd  yd  map
 -1   1  19   1    1
 -1   7  19   7    1
 -1  13  19  13    1
 18  -1  18  14    4
 - npc 33
 20 6  11
 1  11 9
 1  7  1
 1  16 7
 1  4  11
 1  17 12
 1  9  9
 1  16 11
 1  16 2
 1  14 3
 1  13 5