- tilesMazeFourofFour 600
 8  4   8  4   8  4   8  4   8  4   8  4   8  4   8  4   8  4   8  4   8  4   8  4   8  4   8  4   8  4   8  4   8  4   8  4   8  4   8  4
 8  4   8  4   8  4   8  4   8  4   8  4   8  4   8  4   8  4   8  4   8  4   8  4   8  4   8  4   8  4   8  4   8  4   8  4   8  4   8  4
 8  4   8  4   8  4   8  4   8  4   8  4   8  4   8  4   8  4   8  4   8  4   8  4   8  4   8  4   8  4   8  4   8  4   8  4   8  4   8  4
 8  4   8  4   8  4   8  4   8  4   8  4   8  4   8  4   8  4   8  4   8  4   8  4   8  4   8  4   8  4   8  4   8  4   8  4   8  4   8  4
 8  4   8  4   8  4   8  4   8  4   8  4   8  4   8  4   8  4   8  4   8  4   8  4   8  4   8  4   8  4   8  4   8  4   8  4   8  4   8  4
 8  4   8  4   8  4   8  4   8  4   8  4   8  4   8  4   8  4   8  4   8  4   8  4   8  4   8  4   8  4   8  4   8  4   8  4   8  4   8  4
 8  4   8  4   8  4   8  4   8  4   8  4   8  4   8  4   8  4   8  4   8  4   8  4   8  4   8  4   8  4   8  4   8  4   8  4   8  4   8  4
 8  4   8  4   8  4   8  4   8  4   8  4   8  4   8  4   8  4   8  4   8  4   8  4   8  4   8  4   8  4   8  4   8  4   8  4   8  4   8  4
 8  4   8  4   8  4   8  4   8  4   8  4   8  4   8  4   8  4   8  4   8  4   8  4   8  4   8  4   8  4   8  4   8  4   8  4   8  4   8  4
 8  4   8  4   8  4   8  4   8  4   8  4   8  4   8  4   8  4   8  4   8  4   8  4   8  4   8  4   8  4   8  4   8  4   8  4   8  4   8  4
 8  4   8  4   8  4   8  4   8  4   8  4   8  4   8  4   8  4   8  4   8  4   8  4   8  4   8  4   8  4   8  4   8  4   8  4   8  4   8  4
 8  4   8  4   8  4   8  4   8  4   8  4   8  4   8  4   8  4   8  4   8  4   8  4   8  4   8  4   8  4   8  4   8  4   8  4   8  4   8  4
 8  4   8  4   8  4   8  4   8  4   8  4   8  4   8  4   8  4   8  4   8  4   8  4   8  4   8  4   8  4   8  4   8  4   8  4   8  4   8  4
 8  4   8  4   8  4   8  4   8  4   8  4   8  4   8  4   8  4   8  4   8  4   8  4   8  4   8  4   8  4   8  4   8  4   8  4   8  4   8  4
 8  4   8  4   8  4   8  4   8  4   8  4   8  4   8  4   8  4   8  4   8  4   8  4   8  4   8  4   8  4   8  4   8  4   8  4   8  4   8  4
 - collision 300
 0 0 0 0 0 0 0 0 0 0 0 0 0 0 0 0 0 0 0 1
 0 0 0 0 0 0 0 0 0 0 0 0 0 0 0 0 0 0 0 1
 0 0 0 0 0 0 0 0 0 0 0 0 0 0 0 0 0 0 0 1
 0 0 0 0 0 0 0 0 0 0 0 0 0 0 0 0 0 0 0 1
 0 0 0 0 0 0 0 0 0 0 0 0 0 0 0 0 0 0 0 1
 0 0 0 0 0 0 0 0 0 0 0 0 0 0 0 0 0 0 0 1
 0 0 0 0 0 0 0 0 0 0 0 0 0 0 0 0 0 0 0 1
 0 0 0 0 0 0 0 0 0 0 0 0 0 0 0 0 0 0 0 1
 0 0 0 0 0 0 0 0 0 0 0 0 0 0 0 0 0 0 0 1
 0 0 0 0 0 0 0 0 0 0 0 0 0 0 0 0 0 0 0 1
 0 0 0 0 0 0 0 0 0 0 0 0 0 0 0 0 0 0 0 1
 0 0 0 0 0 0 0 0 0 0 0 0 0 0 0 0 0 0 0 1
 0 0 0 0 0 0 0 0 0 0 0 0 0 0 0 0 0 0 0 1
 0 0 0 0 0 0 0 0 0 0 0 0 0 0 0 0 0 0 0 1
 0 0 0 0 0 0 0 0 0 0 0 0 0 0 0 0 0 0 0 1