- tilesMazeThreeofFour 600
 6  2   7  2   8  2   8  2   8  2   8  2   8  2   8  2   8  2   8  2   8  2   8  2   8  2   8  2   8  2   8  2   8  2   8  2   8  2   8  2
 6  3   7  3   8  4   8  4   8  4   8  4   8  4   8  4   8  4   8  4   8  4   8  4   8  4   8  4   8  4   8  4   8  4   8  4   8  4   8  4
 6  4   8  4   8  4   8  4   8  4   8  4   8  4   8  4   8  4   8  4   8  4   8  4   8  4   8  4   8  4   8  4   8  4   8  4   8  4   8  4
 6  4   8  4   8  4   8  4   8  4   8  4   8  4   8  4   8  4   8  4   8  4   8  4   8  4   8  4   8  4   8  4   8  4   8  4   8  4   8  4
 6  4   8  4   8  4   8  4   8  4   8  4   8  4   8  4   8  4   8  4   8  4   8  4   8  4   8  4   8  4   8  4   8  4   8  4   8  4   8  4
 6  4   8  4   8  4   8  4   8  4   8  4   8  4   8  4   8  4   8  4   8  4   8  4   8  4   8  4   8  4   8  4   8  4   8  4   8  4   8  4
 6  4   8  4   8  4   8  4   8  4   8  4   8  4   8  4   8  4   8  4   8  4   8  4   8  4   8  4   8  4   8  4   8  4   8  4   8  4   8  4
 6  4   8  4   8  4   8  4   8  4   8  4   8  4   8  4   8  4   8  4   8  4   8  4   8  4   8  4   8  4   8  4   8  4   8  4   8  4   8  4
 6  4   8  4   8  4   8  4   8  4   8  4   8  4   8  4   8  4   8  4   8  4   8  4   8  4   8  4   8  4   8  4   8  4   8  4   8  4   8  4
 6  4   8  4   8  4   8  4   8  4   8  4   8  4   8  4   8  4   8  4   8  4   8  4   8  4   8  4   8  4   8  4   8  4   8  4   8  4   8  4
 6  4   8  4   8  4   8  4   8  4   8  4   8  4   8  4   8  4   8  4   8  4   8  4   8  4   8  4   8  4   8  4   8  4   8  4   8  4   8  4
 6  4   8  4   8  4   8  4   8  4   8  4   8  4   8  4   8  4   8  4   8  4   8  4   8  4   8  4   8  4   8  4   8  4   8  4   8  4   8  4
 6  4   8  4   8  4   8  4   8  4   8  4   8  4   8  4   8  4   8  4   8  4   8  4   8  4   8  4   8  4   8  4   8  4   8  4   8  4   8  4
 6  4   8  4   8  4   8  4   8  4   8  4   8  4   8  4   8  4   8  4   8  4   8  4   8  4   8  4   8  4   8  4   8  4   8  4   8  4   8  4
 6  4   8  4   8  4   8  4   8  4   8  4   8  4   8  4   8  4   8  4   8  4   8  4   8  4   8  4   8  4   8  4   8  4   8  4   8  4   8  4
 - collision 300
 1 1 1 1 1 1 1 1 1 1 1 1 1 1 1 1 1 1 1 1
 1 0 0 0 0 0 0 0 0 0 0 0 0 0 0 0 0 0 0 0
 1 0 0 0 0 0 0 0 0 0 0 0 0 0 0 0 0 0 0 0
 1 0 0 0 0 0 0 0 0 0 0 0 0 0 0 0 0 0 0 0
 1 0 0 0 0 0 0 0 0 0 0 0 0 0 0 0 0 0 0 0
 1 0 0 0 0 0 0 0 0 0 0 0 0 0 0 0 0 0 0 0
 1 0 0 0 0 0 0 0 0 0 0 0 0 0 0 0 0 0 0 0
 1 0 0 0 0 0 0 0 0 0 0 0 0 0 0 0 0 0 0 0
 1 0 0 0 0 0 0 0 0 0 0 0 0 0 0 0 0 0 0 0
 1 0 0 0 0 0 0 0 0 0 0 0 0 0 0 0 0 0 0 0
 1 0 0 0 0 0 0 0 0 0 0 0 0 0 0 0 0 0 0 0
 1 0 0 0 0 0 0 0 0 0 0 0 0 0 0 0 0 0 0 0
 1 0 0 0 0 0 0 0 0 0 0 0 0 0 0 0 0 0 0 0
 1 0 0 0 0 0 0 0 0 0 0 0 0 0 0 0 0 0 0 0
 1 0 0 0 0 0 0 0 0 0 0 0 0 0 0 0 0 0 0 0
 - portals 5
 xp  yp  xd  yd  map
  7  15   7   0    1