- tilesMazeThreeofFour 600
 6  2   7  2   8  2   8  2   8  2   8  2   8  2   8  2   8  2   8  2   8  2   8  2   8  2   8  2   8  2   8  2   8  2   8  2   8  2   8  2
 6  3   7  3   8  4   8  4   8  4   8  4   8  4   8  4   8  4   8  4   8  4   8  4   8  4   8  4   8  4   8  4   8  4   8  4   8  4  11 22
 6  4   8  4   0 22   1 22   1 22   1 22   1 22   1 22   1 22   1 22   1 22   1 22   1 22   1 22   1 22   2 22   8  4   8  4   8  4  12 22
 6  4   8  4  12 22   1 23   1 23   1 23   1 23   1 23   1 23   1 23   1 23   1 23   1 23   1 23   1 23  12 22   8  4   8  4   8  4  12 22
 6  4   8  4  12 22   8  4   0 22   1 22   1 22   1 22   1 22   1 22   1 22   1 22   1 22   1 22   1 22   1 22   1 22   2 22   8  4  12 22
 6  4   8  4  12 22   8  4   1 23   1 23   1 23   1 23   1 23   1 23   1 23   1 23  12 22   1 23   1 23   1 23   1 23   1 23   8  4  12 22
 6  4   8  4   0 22   1 22   1 22   1 22   1 22   1 22   1 22   1 22   2 22   8  4  12 22   8  4   4  6   5  6   0 22   1 22   2 22  12 22
 6  4   8  4   1 23   1 23  12 22   1 23   1 23   1 23   1 23   1 23  12 22   8  4  12 22   8  4   4  7   5  7   1 23   1 23   1 23  12 22
 6  4   4  6   5  6   8  4  12 22   8  4  11 22   8  4  11 22   8  4  12 22   8  4  12 22   8  4  11 22   8  4   8  4  11 22   8  4  12 22
 6  4   4  7   5  7   8  4  12 22   8  4  12 22   8  4  12 22   8  4  12 22   8  4  12 22   8  4  12 22   8  4   8  4  13 22   8  4  12 22
 6  4   8  4   8  4   8  4  12 22   8  4  12 22   8  4  12 22   8  4  13 22   8  4  12 22   8  4  13 22   8  4   4  6   5  6   8  4  13 22
 6  4   8  4   4  6   5  6  12 22   8  4  12 22   8  4  12 22   8  4   8  4   8  4  12 22   8  4   8  4   8  4   4  7   5  7   8  4   8  4
 6  4   8  4   4  7   5  7  13 22   8  4  12 22   8  4  12 22   0 22   1 22   1 22   1 22   1 22   1 22   1 22   1 22   1 22   1 22   2 22
 6  4   8  4   8  4   8  4   8  4   8  4  12 22   8  4  12 22   1 23   1 23   1 23   1 23   1 23   1 23   1 23   1 23   1 23   1 23   1 23
 6  4   0 22   1 22   1 22   1 22   1 22   2 22   8  4  13 22   8  4   0 22   1 22   1 22   1 22   1 22   1 22   1 22   1 22   1 22   2 22
 - collision 300
 1 1 1 1 1 1 1 1 1 1 1 1 1 1 1 1 1 1 1 1
 1 0 0 0 0 0 0 0 0 0 0 0 0 0 0 0 0 0 0 1
 1 0 1 1 1 1 1 1 1 1 1 1 1 1 1 1 0 0 0 1
 1 0 1 0 0 0 0 0 0 0 0 0 0 0 0 1 0 0 0 1
 1 0 1 0 1 1 1 1 1 1 1 1 1 1 1 1 1 1 0 1
 1 0 1 0 0 0 0 0 0 0 0 0 1 0 0 0 0 0 0 1
 1 0 1 1 1 1 1 1 1 1 1 0 1 0 1 1 1 1 1 1
 1 0 0 0 1 0 0 0 0 0 1 0 1 0 1 1 0 0 0 1
 1 1 1 0 1 0 1 0 1 0 1 0 1 0 1 0 0 1 0 1
 1 1 1 0 1 0 1 0 1 0 1 0 1 0 1 0 0 1 0 1
 1 0 0 0 1 0 1 0 1 0 1 0 1 0 1 0 1 1 0 1
 1 0 1 1 1 0 1 0 1 0 0 0 1 0 0 0 1 1 0 0
 1 0 1 1 1 0 1 0 1 1 1 1 1 1 1 1 1 1 1 1
 1 0 0 0 0 0 1 0 1 0 0 0 0 0 0 0 0 0 0 0
 1 1 1 1 1 1 1 0 1 0 1 1 1 1 1 1 1 1 1 1
 - portals 20
 xp  yp  xd  yd  map
  7  15   7   0    1
  9  15   9   0    1
 20  13   0  13    4
 20  11   0  11    4
 - npc 48
 tp xp yp
 health flower
 20 14 3
 rats
 1  3  3
 1  3  5
 1  11 5
 1  11 11
 1  16 3
 1  18 5
 1  13 11
 1  16 7
 1  1  1
 1  1  7
 1  1  13
 1  5  13
 blobs
 2  2  10
 2  15 8
 2  16 9