- tilesMazeFourofFour 600
 8  2   8  2   8  2   8  2   8  2   8  2   8  2   8  2   8  2   8  2   8  2   8  2   8  2   8  2   8  2   8  2   8  2   8  2  11  2  12  2
11 22   8  4   8  4   8  4   8  4   8  4   8  4   8  4   8  4   8  4   8  4   8  4   8  4   8  4   8  4   8  4   8  4   8  4  11  3  12  3
12 22   8  4   8  4   8  4   8  4   8  4   8  4   8  4   8  4   8  4   8  4   8  4   8  4   8  4   8  4   8  4   8  4   8  4   8  4  12  4
12 22   8  4   8  4   8  4   8  4   8  4   8  4   8  4   8  4   8  4   8  4   8  4   8  4   8  4   8  4   8  4   8  4   8  4   8  4  12  4
12 22   8  4   8  4   8  4   8  4   8  4   8  4   8  4   8  4   8  4   8  4   8  4   8  4   8  4   8  4   8  4   8  4   8  4   8  4  12  4
12 22   8  4   8  4   8  4   8  4   8  4   8  4   8  4   8  4   8  4   8  4   8  4  11 22  14  0  15  0  11 22   8  4   8  4   8  4  12  4
12 22   8  4   8  4   8  4   8  4   8  4   8  4   8  4   8  4   8  4   8  4   8  4  12 22  14  1  15  1  12 22   8  4   8  4   8  4  12  4
12 22   8  4   8  4   8  4   8  4   8  4   8  4   8  4   8  4   8  4   8  4   8  4  13 22  14  2  15  2  13 22   8  4   8  4   8  4  12  4
12 22   8  4   8  4   8  4   8  4   8  4   8  4   8  4   8  4   8  4   8  4   8  4   8  4   8  4   8  4   8  4   8  4   8  4   8  4  12  4
12 22   8  4   8  4   8  4   8  4   8  4   8  4   8  4   8  4   8  4   8  4   8  4   8  4   8  4   8  4   8  4   8  4   8  4   8  4  12  4
13 22   8  4   8  4   8  4   8  4   8  4   8  4   8  4   8  4   8  4   8  4   8  4   8  4   8  4   8  4   8  4   8  4   8  4   8  4  12  4
 8  4   8  4   8  4   8  4   8  4   8  4   8  4   8  4   8  4   8  4   8  4   8  4   8  4   8  4   8  4   8  4   8  4   8  4   8  4  12  4
 0 22   1 22   1 22   1 22   1 22   1 22   1 22   1 22   1 22   1 22   1 22   1 22   1 22   1 22   1 22   1 22   1 22   1 22   2 22  12  4
 1 23   1 23   1 23   1 23   1 23   1 23   1 23   1 23   1 23   1 23   1 23   1 23   1 23   1 23   1 23   1 23   1 23   1 23   1 23  12  4
 0 22   1 22   1 22   1 22   1 22   1 22   1 22   1 22   1 22   1 22   1 22   1 22   1 22   1 22   1 22   1 22   1 22   2 22   8  4  12  4
 - collision 300
 1 1 1 1 1 1 1 1 1 1 1 1 1 1 1 1 1 1 1 1
 1 0 0 0 0 0 0 0 0 0 0 0 0 0 0 0 0 0 0 1
 1 0 0 0 0 0 0 0 0 0 0 0 0 0 0 0 0 0 0 1
 1 0 0 0 0 0 0 0 0 0 0 0 0 0 0 0 0 0 0 1
 1 0 0 0 0 0 0 0 0 0 0 0 0 0 0 0 0 0 0 1
 1 0 0 0 0 0 0 0 0 0 0 0 1 1 1 1 0 0 0 1
 1 0 0 0 0 0 0 0 0 0 0 0 1 1 1 1 0 0 0 1
 1 0 0 0 0 0 0 0 0 0 0 0 1 0 0 1 0 0 0 1
 1 0 0 0 0 0 0 0 0 0 0 0 0 0 0 0 0 0 0 1
 1 0 0 0 0 0 0 0 0 0 0 0 0 0 0 0 0 0 0 1
 1 0 0 0 0 0 0 0 0 0 0 0 0 0 0 0 0 0 0 1
 0 0 0 0 0 0 0 0 0 0 0 0 0 0 0 0 0 0 0 1
 1 1 1 1 1 1 1 1 1 1 1 1 1 1 1 1 1 1 1 1
 0 0 0 0 0 0 0 0 0 0 0 0 0 0 0 0 0 0 0 1
 1 1 1 1 1 1 1 1 1 1 1 1 1 1 1 1 1 1 0 1
 - portal 25
 xp  yp  xd  yd  map
 18  15  18   0    2
 -1  13  19  13    3
 -1  11  19  11    3
 13   6   9  13    5
 14   6  10  13    5
 
 - npc 30
 tp xp yp		tp xp yp
  0 13 10		 0 14 10
  0  2  2		 0 13  3
  0  6  7		 0  8  9
  0 18 11		 0 16  6
  0  3  7		 0  8  3