- tilesMazeOneofFour 600
 3 33   3 33   3 33   3 33   3 33   3 33   3 33   3 36   4 36   6 36   6 36  10 36  11 36   3 33   3 33   3 33   3 33   3 33   3 33   3 33
 3 33   3 33   3 33   3 33   3 33   3 33   3 33   3 36   4 36   6 36   6 36  10 36  11 36   3 33   3 33   3 33   3 33   3 33   3 33   3 33
 3 33   3 33   3 33   3 33   3 33   3 33   3 33   3 36   4 36   6 36   6 36  10 36  11 36   3 33   3 33   3 33   3 33   3 33   3 33   3 33
 3 33   3 33   3 33   3 33   3 33   3 33   3 33   3 36   4 36   6 36   6 36  10 36  11 36   3 33   3 33   3 33   3 33   3 33   3 33   3 33
 3 33   3 33   3 33   3 33   3 33   3 33   3 33   3 36   4 36   6 36   6 36  10 36  11 36   3 33   3 33   3 33   3 33   3 33   3 33   3 33
 3 33   3 33   3 33   3 33   3 33   3 33   3 33   3 36   4 36   6 36   6 36  10 36  11 36   3 33   3 33   3 33   3 33   3 33   3 33   3 33
 3 33   3 33   3 33   3 33   3 33   3 33   3 33   3 36   4 36   6 36   6 36  10 36  11 36   3 33   3 33   3 33   3 33   3 33   3 33   3 33
 3 33   3 33   3 33   3 33   3 33   3 33   3 33   3 36   4 36   6 36   6 36  10 36  11 36   3 33   3 33   3 33   3 33   3 33   3 33   3 33
 3 33   3 33   3 33   3 33   3 33   3 33   3 33   3 36   4 36   6 36   6 36  10 36  11 36   3 33   3 33   3 33   3 33   3 33   3 33   3 33
 3 33   3 33   3 33   3 33   3 33   3 33   3 33   3 36   4 36   6 36   6 36  10 36  11 36   3 33   3 33   3 33   3 33   3 33   3 33   3 33
 3 33   3 33   3 33   3 33   3 33   3 33   3 33   3 36   4 36   6 36   6 36  10 36  11 36   3 33   3 33   3 33   3 33   3 33   3 33   3 33
 3 33   3 33   3 33   3 33   3 33   3 33   3 33   3 36   4 36  12 32  13 32  10 36  11 36   3 33   3 33   3 33   3 33   3 33   3 33   3 33
 3 33   3 33   3 33   3 33   3 33   3 33   3 33   3 36   4 36  12 33  13 33  10 36  11 36   3 33   3 33   3 33   3 33   3 33   3 33   3 33
 3 33   3 33   3 33   3 33   3 33   3 33   3 33   3 36   4 36  12 34  13 34  10 36  11 36   3 33   3 33   3 33   3 33   3 33   3 33   3 33
 3 33   3 33   3 33   3 33   3 33   3 33   3 33   3 36   4 36  12 35  13 35  10 36  11 36   3 33   3 33   3 33   3 33   3 33   3 33   3 33
 
 - collision 300
 1 1 1 1 1 1 1 1 1 0 0 1 1 1 1 1 1 1 1 1
 1 1 1 1 1 1 1 1 1 0 0 1 1 1 1 1 1 1 1 1
 1 1 1 1 1 1 1 1 1 0 0 1 1 1 1 1 1 1 1 1
 1 1 1 1 1 1 1 1 1 0 0 1 1 1 1 1 1 1 1 1
 1 1 1 1 1 1 1 1 1 0 0 1 1 1 1 1 1 1 1 1
 1 1 1 1 1 1 1 1 1 0 0 1 1 1 1 1 1 1 1 1
 1 1 1 1 1 1 1 1 1 0 0 1 1 1 1 1 1 1 1 1
 1 1 1 1 1 1 1 1 1 0 0 1 1 1 1 1 1 1 1 1
 1 1 1 1 1 1 1 1 1 0 0 1 1 1 1 1 1 1 1 1
 1 1 1 1 1 1 1 1 1 0 0 1 1 1 1 1 1 1 1 1
 1 1 1 1 1 1 1 1 1 0 0 1 1 1 1 1 1 1 1 1
 1 1 1 1 1 1 1 1 1 0 0 1 1 1 1 1 1 1 1 1
 1 1 1 1 1 1 1 1 1 0 0 1 1 1 1 1 1 1 1 1
 1 1 1 1 1 1 1 1 1 0 0 1 1 1 1 1 1 1 1 1
 1 1 1 1 1 1 1 1 1 0 0 1 1 1 1 1 1 1 1 1
 
 - portal 20
 xp  yp  xd  yd  map
  9  15  13   7    4
 10  15  14   7    4
  9  -1   9  14    6
 10  -1  10  14    6
 
 - npc 9
 tp xp yp
  0  9  6
  0  9  9
  1 10  7