- tilesMazeOneofFour 600
 3 33   3 33   3 33   3 33   3 33   3 33   3 33   3 36   4 36   6 36   6 36  10 36  11 36   3 33   3 33   3 33   3 33   3 33   3 33   3 33
 3 33   3 33   3 33   3 33   3 33   3 33   3 33   3 36   4 36   6 36   6 36  10 36  11 36   3 33   3 33   3 33   3 33   3 33   3 33   3 33
 3 33   3 33   3 33   3 33   3 33   3 33   3 33   3 36   4 36   6 36   6 36  10 36  11 36   3 33   3 33   3 33   3 33   3 33   3 33   3 33
 3 33   3 33   3 33   3 33   3 33   3 33   3 33   3 36   4 36   6 36   6 36  10 36  10 34   6 32   6 32   6 32   6 32   6 32   6 32   6 32
 3 33   3 33   3 33   3 33   3 33   3 33   3 33   3 36   4 36   6 36   6 36   9 35   6 34   6 34   6 34   6 34   6 34   6 34   6 34   6 34
 3 33   3 33   3 33   3 33   3 33   3 33   3 33   3 36   4 36   6 36   6 36   6 36   6 36   6 36   6 36   6 36   6 36   6 36   6 36   6 36
 6 32   6 32   6 32   6 32   6 32   6 32   6 32   4 34   4 36   6 36   6 36   6 36   6 36   6 36   6 36   6 36   6 36   6 36   6 36   6 36
 6 34   6 34   6 34   6 34   6 34   6 34   6 34   6 34   5 35   6 36   6 36   9 37  10 37   7 39   7 39   7 39   7 39   7 39   7 39   7 39
 6 36   6 36   6 36   6 36   6 36   6 36   6 36   6 36   6 36   6 36   6 36  10 36  11 36   3 33   3 33   3 33   3 33   3 33   3 33   3 33
 6 36   6 36   6 36   6 36   6 36   6 36   6 36   6 36   6 36   6 36   6 36  10 36  11 36   3 33   3 33   3 33   3 33   3 33   3 33   3 33
 7 39   7 39   7 39   7 39   7 39   7 39   7 39   4 37   5 37   6 36   6 36  10 36  11 36   3 33   3 33   3 33   3 33   3 33   3 33   3 33
 3 33   3 33   3 33   3 33   3 33   3 33   3 33   3 36   4 36   6 36   6 36  10 36  11 36   3 33   3 33   3 33   3 33   3 33   3 33   3 33
 3 33   3 33   3 33   3 33   3 33   3 33   3 33   3 36   4 36   6 36   6 36  10 36  11 36   3 33   3 33   3 33   3 33   3 33   3 33   3 33
 3 33   3 33   3 33   3 33   3 33   3 33   3 33   3 36   4 36   6 36   6 36  10 36  11 36   3 33   3 33   3 33   3 33   3 33   3 33   3 33
 3 33   3 33   3 33   3 33   3 33   3 33   3 33   3 36   4 36   6 36   6 36  10 36  11 36   3 33   3 33   3 33   3 33   3 33   3 33   3 33
 
 - collision 300
 1 1 1 1 1 1 1 1 1 0 0 1 1 1 1 1 1 1 1 1
 1 1 1 1 1 1 1 1 1 0 0 1 1 1 1 1 1 1 1 1
 1 1 1 1 1 1 1 1 1 0 0 1 1 1 1 1 1 1 1 1
 1 1 1 1 1 1 1 1 1 0 0 1 1 1 1 1 1 1 1 1
 1 1 1 1 1 1 1 1 1 0 0 1 1 1 1 1 1 1 1 1
 1 1 1 1 1 1 1 1 1 0 0 0 0 0 0 0 0 0 0 0
 1 1 1 1 1 1 1 1 1 0 0 0 0 0 0 0 0 0 0 0
 1 1 1 1 1 1 1 1 1 0 0 1 1 1 1 1 1 1 1 1
 0 0 0 0 0 0 0 0 0 0 0 1 1 1 1 1 1 1 1 1
 0 0 0 0 0 0 0 0 0 0 0 1 1 1 1 1 1 1 1 1
 1 1 1 1 1 1 1 1 1 0 0 1 1 1 1 1 1 1 1 1
 1 1 1 1 1 1 1 1 1 0 0 1 1 1 1 1 1 1 1 1
 1 1 1 1 1 1 1 1 1 0 0 1 1 1 1 1 1 1 1 1
 1 1 1 1 1 1 1 1 1 0 0 1 1 1 1 1 1 1 1 1
 1 1 1 1 1 1 1 1 1 0 0 1 1 1 1 1 1 1 1 1
 
 - portal 10
 xp  yp  xd  yd  map
  9  15   9   0    6
 10  15  10   0    6