- tilesMazeOneofFour 600
 3 33   3 33   3 33   3 33   3 33   3 33   3 33   3 33   3 33   3 33   3 33   3 33   3 33   3 33   3 33   3 33   3 33   3 33   3 33   3 33
 3 33   3 33   3 33   3 33   3 33   3 33   3 33   3 33   3 33   3 33   3 33   3 33   3 33   3 33   3 33   3 33   3 33   3 33   3 33   3 33
 3 33   3 33   3 33   3 33   3 33   3 33   3 33   3 33   3 33   3 33   3 33   3 33   3 33   3 33   3 33   3 33   3 33   3 33   3 33   3 33
 3 33   3 33   3 33   3 33   3 33   3 33   3 33   3 33   4 33   6 32   6 32   6 32   6 32   6 32   6 32   6 32   6 32   6 32   6 32   6 32
 3 33   3 33   3 33   3 33   3 33   3 33   3 33   5 32   4 34   6 34   6 34   6 34   6 34   6 34   6 34   6 34   6 34   6 34   6 34   6 34
 3 33   3 33   3 33   3 33   3 33   3 33   3 33   3 36   4 36   6 36   6 36   6 36   6 36   6 36   6 36   6 36   6 36   6 36   6 36   6 36
 6 32   6 32   6 32   6 32   6 32   6 32   6 32   4 34   4 36   6 36   6 36   6 36   6 36   6 36   6 36   6 36   6 36   6 36   6 36   6 36
 6 34   6 34   6 34   6 34   6 34   6 34   6 34   6 34   5 35   6 36   6 36   9 37  10 37   7 39   7 39   7 39   7 39   7 39   7 39   7 39
 6 36   6 36   6 36   6 36   6 36   6 36   6 36   6 36   6 36   6 36   6 36  10 36  11 36   3 33   3 33   3 33   3 33   3 33   3 33   3 33
 6 36   6 36   6 36   6 36   6 36   6 36   6 36   6 36   6 36   6 36   6 36  10 36  11 36   3 33   3 33   3 33   3 33   3 33   3 33   3 33
 7 39   7 39   7 39   7 39   7 39   7 39   7 39   4 37   5 37   6 36   6 36  10 36  11 36   3 33   3 33   3 33   3 33   3 33   3 33   3 33
 3 33   3 33   3 33   3 33   3 33   3 33   3 33   3 36   4 36   6 36   6 36  10 36  11 36   3 33   3 33   3 33   3 33   3 33   3 33   3 33
 3 33   3 33   3 33   3 33   3 33   3 33   3 33   3 36   4 36   6 36   6 36  10 36  11 36   3 33   3 33   3 33   3 33   3 33   3 33   3 33
 3 33   3 33   3 33   3 33   3 33   3 33   3 33   3 36   4 36   6 36   6 36  10 36  11 36   3 33   3 33   3 33   3 33   3 33   3 33   3 33
 3 33   3 33   3 33   3 33   3 33   3 33   3 33   3 36   4 36   6 36   6 36  10 36  11 36   3 33   3 33   3 33   3 33   3 33   3 33   3 33
 
 - collision 300
 1 1 1 1 1 1 1 1 1 1 1 1 1 1 1 1 1 1 1 1
 1 1 1 1 1 1 1 1 1 1 1 1 1 1 1 1 1 1 1 1
 1 1 1 1 1 1 1 1 1 1 1 1 1 1 1 1 1 1 1 1
 1 1 1 1 1 1 1 1 1 1 1 1 1 1 1 1 1 1 1 1
 1 1 1 1 1 1 1 1 1 1 1 1 1 1 1 1 1 1 1 1
 1 1 1 1 1 1 1 1 1 0 0 0 0 0 0 0 0 0 0 0
 1 1 1 1 1 1 1 1 1 0 0 0 0 0 0 0 0 0 0 0
 1 1 1 1 1 1 1 1 0 0 0 1 1 1 1 1 1 1 1 1
 0 0 0 0 0 0 0 0 0 0 0 1 1 1 1 1 1 1 1 1
 0 0 0 0 0 0 0 0 0 0 0 1 1 1 1 1 1 1 1 1
 1 1 1 1 1 1 1 1 1 0 0 1 1 1 1 1 1 1 1 1
 1 1 1 1 1 1 1 1 1 0 0 1 1 1 1 1 1 1 1 1
 1 1 1 1 1 1 1 1 1 0 0 1 1 1 1 1 1 1 1 1
 1 1 1 1 1 1 1 1 1 0 0 1 1 1 1 1 1 1 1 1
 1 1 1 1 1 1 1 1 1 0 0 1 1 1 1 1 1 1 1 1
 
 - portal 30
 xp  yp  xd  yd  map
  9  15   9   0    8
 10  15  10   0    8
 -1   8  19   8   10
 -1   9  19   9   10
 20   5   0   5   11
 20   6   0   6   11

  - npc 15
 tp xp yp
  0  9  6
  0  9  9
  0 10  7
  0 17  7
  0  4 10