5 0  5 0  5 0  5 0  5 0  5 0  5 0  5 0  5 0  5 0  5 0  5 0  5 0  5 0  5 0  5 0  5 0  5 0  5 0  5 0
5 0  5 0  5 0  5 0  5 0  5 0  5 0  5 0  5 0  5 0  5 0  5 0  5 0  5 0  5 0  5 0  5 0  5 0  5 0  5 0
5 0  5 0  5 0  5 0  5 0  5 0  5 0  5 0  5 0  5 0  5 0  5 0  5 0  5 0  5 0  5 0  5 0  5 0  5 0  5 0
5 0  5 0  5 0  5 0  5 0  5 0  5 0  5 0  5 0  5 0  5 0  5 0  5 0  5 0  5 0  5 0  5 0  5 0  5 0  5 0
5 0  5 0  5 0  5 0  5 0  5 0  5 0  5 0  5 0  5 0  5 0  5 0  5 0  5 0  5 0  5 0  5 0  5 0  5 0  5 0
5 0  5 0  5 0  5 0  5 0  5 0  5 0  5 0  5 0  5 0  5 0  5 0  5 0  5 0  5 0  5 0  5 0  5 0  5 0  5 0
5 0  5 0  5 0  5 0  5 0  5 0  5 0  5 0  5 0  5 0  5 0  5 0  5 0  5 0  5 0  5 0  5 0  5 0  5 0  5 0
5 0  5 0  5 0  5 0  5 0  5 0  5 0  5 0  5 0  5 0  5 0  5 0  5 0  5 0  5 0  5 0  5 0  5 0  5 0  5 0
5 0  5 0  5 0  5 0  5 0  5 0  5 0  5 0  5 0  5 0  5 0  5 0  5 0  5 0  5 0  5 0  5 0  5 0  5 0  5 0
5 0  5 0  5 0  5 0  5 0  5 0  5 0  5 0  5 0  5 0  5 0  5 0  5 0  5 0  5 0  5 0  5 0  5 0  5 0  5 0
5 0  5 0  5 0  5 0  5 0  5 0  5 0  5 0  5 0  5 0  5 0  5 0  5 0  5 0  5 0  5 0  5 0  5 0  5 0  5 0
7 13  8 13  5 0  5 0  5 0  5 0  5 0  5 0  5 0  5 0  5 0  5 0  5 0  5 0  5 0  5 0  5 0  5 0  5 0  5 0
7 13  8 13  5 0  5 0  5 0  5 0  5 0  5 0  5 0  5 0  5 0  5 0  5 0  5 0  5 0  5 0  5 0  5 0  5 0  5 0
5 16  6 16  5 0  5 0  5 0  5 0  5 0  5 0  5 0  5 0  5 0  5 0  5 0  5 0  5 0  5 0  5 0  5 0  5 0  5 0
5 17  6 17  5 0  5 0  5 0  5 0  5 0  5 0  5 0  5 0  5 0  5 0  5 0  5 0  5 0  5 0  5 0  5 0  5 0  5 0